1111111111111
10010000001C1
10000111101C1
1P0011E000001
1111111111111