1111111111111
1e010000000C1
1000011111e01
1P00111E00001
1111111111111