1111111111111111111111111111111111
1E0000000000000C00000C000000000001
101001010e100000101001000e00010101
1010010010101010001001000000010101
1P0000000C00C000e00000000e000000C1
111111111111111111111111111111111111111